Biome,Green
0,0,0,0,0,0,0,0,0,0,0,0
0,0,0,0,0,0,0,0,0,0,0,0
0,0,4,4,0,0,0,0,0,0,0,0
0,0,4,500,0,4,4,4,4,4,0,0
0,0,4,210,0,4,0,0,500,4,0,0
0,0,4,4,4,0,209,0,500,4,0,0
0,0,0,0,0,0,0,4,4,4,0,0
0,0,0,0,0,0,0,0,0,0,0,0
0,0,0,0,0,0,0,0,0,0,0,0
