Biome,Green
500,0,0,0,4,0,4,0,0,0,0,500
0,0,0,0,4,0,4,0,0,0,0,0
4,4,4,0,4,0,4,0,4,4,4,4
0,0,0,0,0,0,0,0,0,0,0,0
0,0,0,0,0,200,0,0,0,0,0,0
0,0,0,0,4,0,4,0,0,0,0,0
3,3,3,3,3,0,4,3,4,4,4,4
4,4,4,4,0,0,0,0,0,0,0,0
500,0,0,0,0,0,0,0,0,0,0,500
