Biome,Green
0,0,0,0,0,0,0,0,0,0,0,0
0,0,0,0,0,0,0,0,0,0,0,0
0,0,0,0,0,0,0,0,0,0,0,0
0,0,0,0,0,0,0,0,0,0,0,0
0,0,0,1,0,3,0,3,0,0,0,0
3,3,4,4,4,3,0,3,3,3,3,3
3,3,3,3,4,3,0,3,4,4,4,4
500,0,201,0,0,0,0,0,0,0,0,0
500,0,201,0,4,0,0,3,3,3,3,3
