Biome,Green
4,4,4,4,4,4,4,4,4,4,4,4
4,0,0,0,0,0,0,0,0,0,0,4
4,0,0,0,0,0,2,2,2,0,0,4
4,0,201,0,0,0,0,0,0,0,0,4
4,0,0,3,0,500,2,503,2,201,0,4
4,0,201,2,503,2,0,2,2,0,0,4
1,0,0,3,2,3,0,0,0,0,0,4
4,0,0,0,0,0,0,1,1,1,0,4
4,4,4,4,4,4,4,4,0,0,4,4
