Biome,Hot
0,502,0,0,0,0,0,0,0,0,0,0
0,0,1,0,0,0,0,0,0,0,0,0
0,0,0,1,0,0,0,206,200,0,0,0
0,0,0,0,1,0,0,0,0,0,0,0
0,0,0,0,0,1,208,0,0,0,1,0
0,0,0,1,0,0,1,0,0,1,0,0
0,0,1,0,0,0,0,0,1,0,0,0
0,1,0,0,206,202,0,1,0,0,501,0
1,0,0,0,0,0,0,0,0,0,0,0
