Biome,Hot
0,1,0,0,0,1,0,0,0,0,0,0
0,1,0,501,0,1,0,0,0,0,0,0
0,1,0,203,0,1,0,0,0,0,0,0
0,0,0,0,0,0,0,0,0,0,0,0
0,0,1,1,1,0,0,0,0,0,0,0
0,0,0,0,0,0,0,0,206,1,1,1
0,0,0,0,0,0,0,0,0,0,0,0
0,0,0,0,0,0,1,0,202,502,0,0
0,0,0,0,0,0,1,0,0,0,0,0
