Biome,Hot
0,0,0,0,0,0,0,0,0,0,0,0
0,0,0,0,0,0,206,0,0,0,0,0
0,0,0,1,0,0,0,0,1,0,0,0
0,0,1,0,0,0,0,0,0,1,0,0
0,0,0,0,0,208,0,0,0,0,0,0
0,0,206,0,0,0,0,0,0,206,0,0
0,0,0,1,0,0,0,0,1,0,0,0
0,0,0,0,1,0,0,1,0,0,0,0
0,0,0,0,0,0,0,0,0,0,0,0
