Biome,Ice
0,0,0,0,0,0,0,0,0,0,0,0
0,0,0,0,0,0,0,0,0,0,0,0
0,0,0,0,0,0,0,0,0,0,0,0
0,0,0,0,0,6,204,6,0,0,0,0
0,0,0,0,6,0,0,502,6,0,0,0
0,0,0,0,6,502,0,0,6,0,0,0
0,0,0,0,0,6,204,6,0,0,0,0
0,0,0,0,0,0,0,0,0,0,0,0
0,0,0,0,0,0,0,0,0,0,0,0
