Biome,Ice
0,0,0,0,0,0,0,0,0,0,0,0
0,0,0,0,0,0,0,0,0,0,0,0
0,0,0,0,0,0,0,0,0,0,0,0
0,0,8,8,8,0,0,2,2,2,0,0
0,0,1,502,0,204,0,0,501,2,0,0
0,0,7,502,0,204,0,203,0,2,0,0
0,0,8,8,8,0,0,2,2,2,0,0
0,0,0,0,0,0,0,0,0,0,0,0
0,0,0,0,0,0,0,0,0,0,0,0
