Biome,Ice
502,0,0,0,0,0,0,0,0,0,0,502
8,8,8,0,0,0,0,0,8,8,8,8
0,0,8,8,8,0,0,8,8,0,0,0
0,0,0,0,0,204,204,0,0,0,0,0
0,0,0,0,0,204,204,0,0,0,0,0
0,0,8,8,0,0,0,8,8,0,0,0
8,8,8,0,0,0,0,0,8,8,8,0
502,500,500,500,0,0,0,0,0,0,8,8
0,202,202,202,0,0,0,0,0,0,502,8
