Biome,Ice
6,6,6,6,6,6,6,6,6,6,6,6
6,0,0,0,0,0,0,0,0,0,0,6
6,0,0,0,0,0,0,0,0,0,0,6
6,0,0,0,0,0,0,0,0,0,0,6
6,0,0,0,0,0,0,0,0,0,0,6
6,6,8,8,8,0,0,0,0,0,0,6
6,0,0,502,204,0,204,8,8,8,8,6
6,200,0,0,0,0,0,0,0,0,502,6
6,6,6,6,6,6,6,6,6,6,6,6
