Biome,Ice
0,0,0,0,0,0,0,0,0,0,0,0
0,0,0,0,1,0,0,0,1,0,0,0
0,0,0,0,1,0,0,1,1,0,0,0
0,0,0,0,1,0,0,1,1,0,200,0
0,0,0,0,0,0,0,0,0,0,0,0
0,0,0,0,0,0,0,0,0,0,0,0
1,1,0,1,0,1,1,1,1,1,1,1
0,0,0,1,0,0,0,0,0,0,0,0
0,501,0,1,0,0,0,0,201,0,0,502
