Biome,Ice
0,0,0,0,0,0,0,0,0,0,0,0
501,0,0,1,0,0,0,0,0,0,0,0
1,1,1,1,0,0,1,1,1,1,1,1
0,0,0,0,0,0,0,0,0,0,0,0
0,0,0,0,0,1,0,0,0,0,0,0
0,0,0,0,0,0,0,0,0,0,0,0
1,1,1,1,0,0,1,1,1,1,1,1
0,0,203,0,0,0,0,0,0,0,0,0
0,0,0,1,0,0,0,0,0,0,0,0
