Biome,Ice
500,0,0,7,0,0,0,0,7,0,0,500
500,0,0,204,0,0,0,0,204,0,0,500
7,7,7,7,0,0,0,0,7,7,7,7
0,0,0,0,0,7,7,0,0,0,0,0
0,1,0,0,0,1,7,0,0,0,0,0
0,0,0,0,0,0,0,0,0,0,0,0
6,200,0,6,6,0,8,0,6,6,6,6
6,0,0,0,6,0,8,0,0,0,0,0
6,0,0,500,6,500,8,203,0,0,501,0
