Biome,Normal,,,,,,,,,,
0,0,0,0,0,0,0,0,0,0,0,0
0,0,0,0,0,0,0,0,0,0,0,0
0,1,0,0,0,0,0,0,0,0,0,0
0,0,203,200,200,200,200,200,0,0,0,0
0,0,0,200,200,200,200,200,1,0,0,0
0,0,0,200,200,200,200,200,0,0,0,0
0,0,0,0,0,0,0,0,0,0,0,0
0,0,0,0,0,0,0,0,0,0,0,0
0,0,0,0,0,0,0,0,0,0,0,0
