Biome,Normal
2,0,0,0,0,0,0,0,0,0,0,2
0,2,0,0,0,0,0,0,0,0,2,0
0,0,0,0,0,0,0,0,0,0,0,0
0,0,0,1,1,1,0,1,1,1,0,0
0,0,0,1,0,0,0,0,202,1,0,0
0,0,0,1,501,202,202,501,501,1,0,0
0,0,0,1,1,1,1,1,1,1,0,0
2,2,0,0,0,0,0,0,0,0,0,0
2,0,0,0,0,0,0,0,0,0,0,0
