Biome,Normal
2,2,501,0,202,202,0,202,0,0,0,2
0,2,2,0,0,0,0,0,0,2,2,0
0,0,2,2,2,0,0,2,2,2,0,0
0,0,0,0,0,0,0,0,0,0,0,0
0,0,0,0,0,0,0,0,0,0,0,0
0,0,0,0,0,0,0,0,0,0,0,0
0,0,2,2,2,0,0,2,2,2,0,0
2,2,201,503,0,0,0,0,503,201,2,0
2,501,201,0,0,0,0,0,0,201,501,2
